ID,Name,Power,Killpoints,Deads,T1 Kills,T2 Kills,T3 Kills,T4 Kills,T5 Kills,Total Kills,T45 Kills,Ranged,Rss Gathered,Rss Assistance,Helps,Alliance
28305327,ᴹᴬᴰ Trend,102673324,5860955270,39384860,55231810,22137812,22965281,250214940,160581138,511130981,410796078,0,24584011686,37317844111,66438,[GP70]Glorious Phoenix
3029412,Mojoran,98175940,3596256287,18027047,71181286,3805443,7951146,153474940,100392758,336805573,253867698,0,26208848261,5135364719,43684,[GP70]Glorious Phoenix
132374024,亗TC ÖZKAN亗,87862468,2385632431,13001701,104788346,4600666,6874315,129853233,51472192,297588752,181325425,0,22413159670,10466203604,112552,[GP70]Glorious Phoenix
72331761,ᶠᵁUncDennis,86805130,3551212720,22303748,48310923,5700743,7061205,139322335,105434044,305829250,244756379,0,29888650305,5858335934,27498,[GP70]Glorious Phoenix
23745593,illegal 2b Zero,86281376,3529931276,23647704,52433533,2506846,5051507,139610775,104905855,304508516,244516630,0,27028734911,5370180244,103528,[GP70]Glorious Phoenix
119387015,ᵛᶰTommit,84049496,847102999,7262463,16474818,394217,1214643,43518785,20148659,81751122,63667444,731376,28016095240,1684683380,50731,[GP70]Glorious Phoenix
68285631,亗TC BLİTZ亗,83851027,2433590185,20163226,55650158,7469405,8461051,123858590,56754562,252193766,180613152,0,25992069709,11207395011,97481,[GP70]Glorious Phoenix
164455733,Birba 13,83576681,158486678,9302658,78844,12223,2251,5679130,5082308,10854756,10761438,0,5024018049,345581108,88090,[GP70]Glorious Phoenix
160009660,ƦoƄ乂KenyT,82515472,563996012,1946450,21580372,886587,1649616,26164322,14483254,64764151,40647576,0,3067382584,2084263142,51007,[GP70]Glorious Phoenix
61835967,うらりひょん,80215674,3819771471,20820583,79640015,8472754,440220,141938672,118287518,348779179,260226190,0,35600021905,6076036521,137447,[GP70]Glorious Phoenix
132004133,亗 TC EMRE 亗,80085221,1180077816,5835416,38699132,2581998,2796401,55329625,30134607,129541763,85464232,0,18292774432,7286984015,84669,[GP70]Glorious Phoenix
28632304,d x n i e l,79969836,733415298,13765883,5977724,3639596,5812723,31733759,19217604,66381406,50951363,0,11892909167,1033343872,66855,[GP70]Glorious Phoenix
40759776,ᶠᵁPapaDereK,78910633,1887717425,19957150,48473277,7392536,7107702,86138423,48671133,197783071,134809556,0,18634987478,8688951695,66916,[GK70]Glorious Knights xXx
131403999,sfᴬᴸThahT,77061824,1970984216,6902762,71023150,4326585,10808454,68589620,60949820,215697629,129539440,105544,12321391359,4838188035,59949,[GP70]Glorious Phoenix
131852602,Dawiid59,76670707,637569327,8542775,3883179,1901103,2098259,23578935,19440405,50901881,43019340,817776,12304836393,1104217175,78763,[GK70]Glorious Knights xXx
158851676,ᴷˢ Janus,75996939,422679714,3311351,18529773,1149334,1826593,19120136,10908368,51534204,30028504,0,14092582207,347061084,82395,[GP70]Glorious Phoenix
131415314,亗Şövalye亗,74508953,2180321853,9786869,48228407,3714829,6053856,108491129,52705990,219194211,161197119,0,12159073508,7572693926,73465,[GP70]Glorious Phoenix
159504208,ˢʷMikeTX,74230954,418899328,3460234,2284694,461251,496357,18036060,11758693,33037055,29794753,0,9912854502,955002140,54379,[GP70]Glorious Phoenix
26348428,IX Sky Dragon,73731180,1511064337,18806070,14772525,2414698,3306484,60725198,44140126,125359031,104865324,0,21977932517,11330871336,48126,[GP70]Glorious Phoenix
26629725,ᴱ ᶻ Gazda,73700946,6901080593,48030325,5495007,1487252,2540357,172698010,257993278,440213904,430691288,922732,26166312639,28629299658,229576,[GP70]Glorious Phoenix
163361716,ᴳᴷAngie,70900890,417817973,5931804,3739205,2211813,3845609,33026439,3349984,46173050,36376423,0,3193376280,29386316947,35374,[GP70]Glorious Phoenix
76883310,ᴹᴰMeomeo鬼,70307190,3574908213,23648293,53933428,8473523,12152643,178188723,85833834,338582151,264022557,624412,14947681818,19557932001,128742,[GP70]Glorious Phoenix
163618408,ᴳᴾDab,69807421,337760238,5939636,1639920,358122,847720,14838521,9246996,26931279,24085517,0,7770280936,607033600,35292,[GP70]Glorious Phoenix
134392036,LocalDimwit,69483142,992492967,4718999,4992326,761313,550949,35660622,31558093,73523303,67218715,47074,15339500108,1761933060,51279,[GP70]Glorious Phoenix
155201729,Tánĵirø,69322219,717595057,6103873,3055919,7759863,1952822,32456884,18454201,63679689,50911085,0,10295247895,3918514574,52277,[GP70]Glorious Phoenix
130945166,Cynâde,68476789,806255678,4573304,38637393,1067848,820321,29343314,24983904,94852780,54327218,0,8918367984,2417057015,62468,[GP70]Glorious Phoenix
80319752,彡Guan yu,68339397,2868746079,18479574,169600476,8879476,14242483,205794324,35107693,433624452,240902017,0,21679424849,8300632710,131717,[GP70]Glorious Phoenix
163418409,ᵐˢGristrat,67562078,244180208,5368743,2182734,868178,360754,12903105,5576662,21891433,18479767,0,5425525713,152674194,56421,[GP70]Glorious Phoenix
133187073,Huo Sanji,67326819,527180234,9814472,7724800,2107655,1392086,23251556,14166803,48642900,37418359,1089729,17663800166,4040290448,76576,[GP70]Glorious Phoenix
56150080,Gale Dragon IX,67193327,485601958,11973145,9495214,1963690,2947484,24183144,11307708,49897240,35490852,0,15556014772,8918979977,23263,[GP70]Glorious Phoenix
103475347,ᴳᴾTinh,66890853,132948356,11844245,37976210,875059,494079,6167186,2997741,48510275,9164927,0,21536508162,6678533860,31767,[GP70]Glorious Phoenix
161020200,Rexas,66854559,146072255,6425951,1070855,169962,46170,8545980,2993684,12826651,11539664,0,3331150525,2822951165,12703,-
29548464,E Z Z E,65933635,395027985,12417254,2335647,714613,913995,18539949,10203808,32708012,28743757,0,17415204788,18852179319,68334,[GP70]Glorious Phoenix
120595838,Vicious8,65630375,3088536049,15587263,9285397,2801344,6428083,141684047,81926174,242125045,223610221,402805,9712077491,7127684843,42707,[SDVD]uw)@ yugly
159950851,亗 TAHİR 亗,64621346,296760169,3100350,33995516,1754078,2524380,13712561,6961489,58948024,20674050,0,10395384625,5044404522,37889,[GP70]Glorious Phoenix
164130779,ᴳᴷJakesully,64023084,303469136,2290638,7364652,2195670,717764,17088621,6192380,33559087,23281001,0,8106940326,1375667162,30686,[GP70]Glorious Phoenix
158217348,ᴳᴾDudububu,63044186,313377968,5556609,13763784,876592,802822,16266878,7149598,38859674,23416476,0,14702681294,774135560,71300,[GP70]Glorious Phoenix
151118627,ˣᶜⱽGrinch,63042292,322255071,3504001,843635,1308135,2185856,6936569,12068048,23342243,19004617,0,10505780633,1832878235,40718,[GP70]Glorious Phoenix
158621460,BPFuji,62877699,505677524,4384330,478814,195403,277159,17976380,16215926,35143682,34192306,0,7910180847,5386959697,20721,[GP70]Glorious Phoenix
131536048,Dalian,62697168,261455894,3002779,4584490,227235,365434,8523635,8669322,22370116,17192957,0,5884121445,2761315722,72101,[GP70]Glorious Phoenix
139342930,ᴳᴷCaptChaos,62627880,207865982,2070682,911403,987942,350062,8131691,6149533,16530631,14281224,0,9525677407,630897703,24899,[GP70]Glorious Phoenix
158549491,๖ۣۜiCe14・ツ,62251898,483649013,4796833,1974908,863807,430417,21933045,13023715,38225892,34956760,0,9838573611,4265129075,45301,[GP70]Glorious Phoenix
164096873,Baumwart,62118354,115759918,2100365,3665793,550002,274939,4785810,3248445,12524989,8034255,0,8051102428,42266535,22558,[GP70]Glorious Phoenix
163383725,EpicDuke,61680160,296343858,3876394,1702050,147243,233433,12959219,8259152,23301097,21218371,0,7736758976,843778832,30660,[GP70]Glorious Phoenix
160035424,ᴮᵒˣʸFish,61384236,444352326,3265964,4695800,3131589,3305322,28915594,6738638,46786943,35654232,0,6132161939,4216428741,32551,[GY70]Glorious Yokai
158318948,Sun Wave,61314809,280486754,3685571,3693571,797513,1582131,15734483,5723983,27531681,21458466,0,11423933850,693869963,55281,[GP70]Glorious Phoenix
163163919,ᵐᶠ Doom,61057758,255546817,3206752,694587,245172,1167374,9390988,7816909,19315030,17207897,0,6366555312,321104000,30459,[GP70]Glorious Phoenix
160114256,ᴳᴷCapybaraヅ,60742911,277904422,2024018,174403,3593059,2149656,13769038,6219721,25905877,19988759,0,4603008251,2525808871,22932,[GP70]Glorious Phoenix
81474705,ᴳᴾLẩu,60520700,403340283,5010204,43645677,4996696,1278249,21495864,8227306,79643792,29723170,0,13487713279,2578437584,70887,[GP70]Glorious Phoenix
145208310,ᴳᴾ420Hz,59412615,282070061,3804124,6973387,243833,120002,16377009,5796881,29511112,22173890,0,8420342555,96960001,13591,-
162935228,Хотабич,59111206,48545792,3881272,361074,535459,143355,2670240,1006342,4716470,3676582,0,3715244450,1329879253,24810,[GP70]Glorious Phoenix
158804916,々 YORU,59088351,409216303,4886974,25061928,611687,437976,20035106,10043879,56190576,30078985,0,7553328136,1140449104,49999,[GP70]Glorious Phoenix
160954597,ᴳᴾSRetSR,58964192,146281881,3983160,15793595,782978,462949,7255563,3357489,27652574,10613052,0,15880659441,2837716819,52470,[GP70]Glorious Phoenix
163946647,ᴳᴷGuvna Ru,58878747,74565612,3457928,11912330,296492,26858,2196775,2475749,16908204,4672524,0,6680662985,1133532907,32162,[GP70]Glorious Phoenix
158487166,ᴳᴾ Cartu,58806091,111651928,3083450,651480,463938,427599,5667868,2610234,9821119,8278102,0,9022770213,371902576,66869,[GP70]Glorious Phoenix
163446113,WAR T0RT0ISE,58644354,156121571,1733693,372705,298138,274186,7628617,3903392,12477038,11532009,0,9105257744,1339356209,32297,[GP70]Glorious Phoenix
160008338,L0rdFarquad,58556466,130617234,1415853,1010991,352192,185968,6403250,3246714,11199115,9649964,0,10109011056,524295288,21922,[GP70]Glorious Phoenix
164413570,Dazé,58460292,114414077,3890006,563959,271120,280214,5484033,2889893,9489219,8373926,0,7595592420,873638057,40497,[GP70]Glorious Phoenix
152543100,Fruits,57234455,563473175,4655085,3367965,1694775,3566028,28816662,12848965,50294395,41665627,0,10263465909,2584543687,25609,[GP70]Glorious Phoenix
163619192,衁DadTheFather,57119456,194495523,3049214,874105,422568,410909,7579447,5801873,15088902,13381320,0,5361093640,4854636,39113,[GP70]Glorious Phoenix
160374547,๖ۣۜGassi・ツ,56553992,539690967,4814447,1464258,1064296,1752891,27956298,12534749,44772492,40491047,0,9194417757,1079757100,36326,[GP70]Glorious Phoenix
163290028,Ŝukuna,56489247,284671577,5621589,3722485,3564750,3760420,17923614,4125988,33097257,22049602,0,396497960,8402050524,15106,[GP70]Glorious Phoenix
158960144,APOSTL,54867197,152406679,4243864,2977128,362313,489552,7506626,3703108,15038727,11209734,0,11289220606,532633794,54473,[GP70]Glorious Phoenix
5599940,Heo Đất 2K7,54264667,623170520,14992367,8470474,1049807,1918253,30068542,15550919,57057995,45619461,568325,16278682470,14614906616,45182,[70Gp]GPhoenixfarm
166294671,么BlackKnight,54191789,45985257,1955360,430859,632893,243165,1686714,1339675,4333306,3026389,0,7415923372,236913718,18380,[GP70]Glorious Phoenix
163276358,Min鬼,54119031,658085247,4771155,7349239,924970,1987770,47033582,8823928,66119489,55857510,0,5896985374,12287288026,62559,[GP70]Glorious Phoenix
159492636,ᵂSerjant,53971534,278205745,4624843,848546,434639,479002,14912385,6306345,22980917,21218730,0,6950528174,382998621,38987,[GP70]Glorious Phoenix
159974138,ˢᵖMelanie1st,53673632,44849856,1115490,595824,967468,809639,2613036,671342,5657309,3284378,0,7829217362,3053660187,28274,[GP70]Glorious Phoenix
159527760,ᴰᵂdEjavu,53424643,122448975,5664698,1361179,2039599,2295143,7255341,1818178,14769440,9073519,0,12089746651,714015288,53068,[GP70]Glorious Phoenix
164520085,Tentacool,53337505,99851712,1688007,168374,155196,117369,3575415,3164201,7180555,6739616,0,6676429004,189979942,24793,[GP70]Glorious Phoenix
158993892,KimkioMiuu,53239390,124801156,4091642,1838611,492437,1226010,7611850,2121301,13290209,9733151,0,7920606866,940027565,39564,[GP70]Glorious Phoenix
163878320,ᴳᴾ Cota,53147243,137621962,4200710,1733040,604451,765003,6460320,3420162,12982976,9880482,0,7520090153,1398645719,21893,[GP70]Glorious Phoenix
163057353,ᴳᴾTiger,53107158,244401520,4050779,38719991,441709,461581,12147344,5622717,57393342,17770061,0,6711684707,1244324872,53319,[GP70]Glorious Phoenix
163338310,メ Cá メ,52605707,455239992,5753073,9695680,1617874,3272302,28923458,7387066,50896380,36310524,0,7670910188,752648265,21553,[GP70]Glorious Phoenix
164050548,Torres501,52260883,81498971,3533946,406469,299053,744378,4496346,1643930,7590176,6140276,0,5297056677,5761305113,21490,[GP70]Glorious Phoenix
159078600,工sŦєđdy,51753303,21245412,1115261,274084,231266,112966,876962,575329,2070607,1452291,0,7891067650,509928271,12563,[GP70]Glorious Phoenix
145971166,TOPIN,51505193,199424907,5908816,730118,316700,108606,9314640,5253233,15723297,14567873,0,7186738385,560445506,25551,[GK70]Glorious Knights xXx
160023302,Darth HeK,51259099,49985906,2040143,46280,141987,109214,1894542,1515520,3707543,3410062,0,9411450106,1021225600,23873,[GP70]Glorious Phoenix
158489648,Albert WESKER,50959783,150008570,4009749,1152380,430947,210490,6986690,3910367,12690874,10897057,0,4469239542,651542360,19880,[GP70]Glorious Phoenix
160660200,ᴳᴾ MarkiPat,50548390,98735676,3865545,218194,236626,148314,5161315,2300619,8065068,7461934,0,10141103618,40119544,46714,[GP70]Glorious Phoenix
158248873,Petiir,50125986,343655940,4680819,34961132,1720146,719593,20793639,6120433,64314943,26914072,0,7457286324,1338681452,44525,[GP70]Glorious Phoenix
91125828,DarknessGaul,50013679,300886406,9966593,2512682,2846901,4984317,14350942,6562169,31257011,20913111,19832,10662517192,2894308483,32690,[GP70]Glorious Phoenix
138821811,ᴳᴷBelgarion,49598410,36353600,4634863,75794,14646,85945,1312583,1141977,2630945,2454560,0,6012292978,347203365,17797,[GK70]Glorious Knights xXx
158497141,ᴳᴾ Loralay,49499790,172993126,3780662,2168724,1030850,572043,11231027,2794962,17797606,14025989,0,5743433135,709862617,23093,[GP70]Glorious Phoenix
162520877,Mi鬼,48727998,288741986,7771696,31692593,2524157,617711,19350051,4069190,58253702,23419241,0,9722738264,2652227234,80444,[GP70]Glorious Phoenix
160432477,ᴳᴾMatador,48451052,55832723,3800813,977468,237661,214837,3064948,1182654,5677568,4247602,0,3471284869,138308142,10688,[GP70]Glorious Phoenix
158425106,ᴳᴾELF亗,48287300,224292592,3190015,7868661,373979,580463,12181605,4891650,25896358,17073255,0,6496585517,864561085,32380,[GP70]Glorious Phoenix
163531884,ˢᵖmeldraws,48076133,21799465,264779,1123815,20791,168495,1434328,325793,3073222,1760121,0,6560287595,1480222959,15664,[GY70]Glorious Yokai
164023585,DiadiaZenia,47996805,47536723,334107,293035,113369,316092,2453285,1072708,4248489,3525993,0,7261986382,64748616,15205,[GP70]Glorious Phoenix
163529679,C0mbat Sl0th,47919061,95062521,2538137,737349,614811,291480,6736315,1257818,9637773,7994133,0,8666285137,783717312,24307,[GP70]Glorious Phoenix
159982329,ThePunisher09,47157561,213585314,3043698,21018774,1473771,3060687,15706797,1856165,43116194,17562962,0,7988054016,1410018222,15878,[GP70]Glorious Phoenix
64384882,Şövalye F1,47138823,122124474,6175156,7580821,614239,675453,7221186,2223308,18315007,9444494,0,12363830993,13236838756,29421,[GK70]Glorious Knights xXx
160289740,ˢʷMarcin,46584195,249692030,4680631,8223921,1300051,1212451,12868370,5595682,29200475,18464052,0,8778965960,359395300,15488,-
163344388,Uki Perkele,46266924,146413246,2316978,362504,107468,177505,5557777,4491901,10697155,10049678,0,8960825864,361233234,18352,[GP70]Glorious Phoenix
161228320,ᴳᴷみなとヅ,45341613,244624001,5430277,2990757,867235,812220,15251200,4326525,24247937,19577725,0,6844774883,1485488384,8941,[GP70]Glorious Phoenix
164022495,MegaDead,45272007,177188501,4395485,3534209,368251,184932,7173821,5163361,16424574,12337182,0,8977549050,219584658,34204,[GP70]Glorious Phoenix
163229857,ⱽJohnatanZ,45125791,292698071,5783272,2829615,674891,562104,14773229,7040083,25879922,21813312,0,5087284340,652357101,36367,[GP70]Glorious Phoenix
158489827,ᴳᴾcococanbo,43732327,147592970,3891320,1228781,730608,578032,6857743,3749822,13144986,10607565,0,8975417119,215841074,15790,[GP70]Glorious Phoenix
163269105,ᴳᴷBangDelau,43700453,110294910,1994786,30213,58685,152017,5399289,2778527,8418731,8177816,0,9484453941,9000000,41759,[GP70]Glorious Phoenix
163269089,Y u n,43709476,204648349,1883018,8766645,566380,1406620,14688794,2462392,27890831,17151186,0,3743087550,302628278,48593,[GP70]Glorious Phoenix
162678340,Wallenstei,43441969,23570156,5339792,128882,182786,202437,787418,724744,2026267,1512162,0,7362741903,60544546,14954,[GP70]Glorious Phoenix
163516584,Mix96,43104778,32534972,1909821,36722,68666,13729,1046196,1093671,2258984,2139867,0,8757827199,439689236,19723,[GP70]Glorious Phoenix
160425860,乛Shimmy,42824599,147664031,4319452,393385,154297,255940,7924920,3350190,12078732,11275110,0,5046442348,1073170573,28784,[GP70]Glorious Phoenix
164057902,Will of Lion,42763529,130735836,1618135,1101411,1037721,765668,10063536,1237104,14205440,11300640,0,5342998615,2817946889,18614,[GK70]Glorious Knights xXx
141292962,E Z Z E JR,42595914,103540031,4765482,209818,70511,93429,5320197,2489068,8183023,7809265,0,7436722710,6883917428,41546,[GK70]Glorious Knights xXx
159682171,ᵛᶰGấu ᶰ,42545636,214493476,2788750,5371891,5271743,4836253,12577760,2887650,30945297,15465410,0,7451030635,8755955702,33225,[GK70]Glorious Knights xXx
164107000,ᴳᴷHooper15c,42463246,22063610,817893,207201,196309,15988,730282,713139,1862919,1443421,0,10572501123,176170167,19211,[GP70]Glorious Phoenix
150095140,BraveDaniel,42283726,256290906,6161307,964293,419853,1385713,11086317,6942616,20798792,18028933,0,6116247891,170000000,13270,[GP70]Glorious Phoenix
164100974,ᵐˢSai Jin,42188405,65125055,3143251,341535,315392,128531,3496944,1447120,5729522,4944064,0,4532761674,629201789,29061,[GP70]Glorious Phoenix
163276291,Kun鬼,42052325,693168921,6325350,34556747,7800792,9741742,49066644,7051129,108217054,56117773,0,3457442302,11296277841,42554,[GP70]Glorious Phoenix
163303590,Tupacclub,41866657,25062815,2610290,38006,278965,230306,624926,866340,2038543,1491266,0,7944146459,335959969,18782,[GK70]Glorious Knights xXx
163567825,ГᴬᴷᴱTaxi,41791850,530840555,4768660,70517679,2154506,17793462,34011740,5056838,129534225,39068578,0,6319650138,9943305303,27197,[GP70]Glorious Phoenix
159906441,Burjuvazı,41639183,38090252,2329642,1164573,149147,208471,2620324,526096,4668611,3146420,0,4229872988,551522290,9991,-
159859578,ᶜᵛThangMax,41528097,79585114,5272003,326952,318242,733220,3816236,1889400,7084050,5705636,0,7230285167,636793647,12296,-
163387381,ᶠᵁwolverine,41155277,163703875,501436,1123907,715228,701892,11438171,2242968,16222166,13681139,0,6652595574,276946165,13749,[GP70]Glorious Phoenix
160022048,ᴮᵒˣʸFarts,41119192,72236968,3716216,1485230,677739,1422901,4273520,1107882,8967272,5381402,0,3489887172,1476471129,23548,[GK70]Glorious Knights xXx
23745592,The BoogieMan,41042004,44170322,6697736,32330,34201,255816,2010645,1148287,3481279,3158932,0,12145926716,13315691066,9585,[GK70]Glorious Knights xXx
98779642,Guan yu war,40978074,55507190,6307425,423281,34576,296808,2976639,1219988,4951292,4196627,0,11114456236,1478250212,7339,[GP70]Glorious Phoenix
163289266,VictorX88,40709532,166113896,4278841,170550,93214,588227,12333439,2010303,15195733,14343742,0,6787058119,1107087422,46418,-
163382270,ᶠᵁKingAlex4,40681695,77023623,3025291,7099176,1171663,1219853,4954499,941803,15386994,5896302,0,2166127778,617093019,9270,[70Gp]GPhoenixfarm
163349111,ⱽˢ Jason,40608948,72256076,3188405,1360654,305578,240655,4414377,1313320,7634584,5727697,0,4099314901,278924723,8550,-
160012358,ˢᵖ John Mac,40593286,41195673,3359963,101469,133647,204269,1665247,1171927,3276559,2837174,0,8591007285,100724000,15618,[GP70]Glorious Phoenix
163426429,seventy four,40087547,257323689,3665624,9383328,333553,6719117,14200447,4294949,34931394,18495396,0,11016030426,880001045,47836,[GP70]Glorious Phoenix
163568241,ᴵᴷ A n n,40042802,341808402,4357741,10592182,6649557,3972038,22073800,4488235,47775812,26562035,0,5849904282,2036957005,48350,[GP70]Glorious Phoenix
158368483,asukoee,39755868,39423852,4636036,303950,924986,526690,2207835,666399,4629860,2874234,0,7530031065,1576181683,23381,[GK70]Glorious Knights xXx
164013484,Old Prosperity,39519294,18352624,1176347,100691,100395,9869,368032,720595,1299582,1088627,0,5896558495,217882575,11527,[GP70]Glorious Phoenix
163357954,Myteic,39349806,49930544,1171324,196893,342090,180579,2440391,1204038,4363991,3644429,0,4542965567,385449,9607,[GP70]Glorious Phoenix
164250777,NOTTODAY,39236809,76130305,2771384,2111887,1111000,3651542,4150984,868496,11893909,5019480,0,1567338460,113700009,5891,[GP70]Glorious Phoenix
160074254,Lão bản,38932166,588918945,5505719,30051469,3735327,2146182,37155575,9764876,82853429,46920451,0,5103761247,860656161,46021,[GP70]Glorious Phoenix
164816959,WAR TORT0ISE,38932091,45572124,1125438,94414,202130,31338,2952143,775110,4055135,3727253,0,8826784994,2050034471,13505,[GK70]Glorious Knights xXx
160034110,ˢᵖCatwoman,38888858,25755152,2025116,13344,30104,20014,1707802,426710,2197974,2134512,0,7139199374,318667969,29419,[GK70]Glorious Knights xXx
160071725,TacLethal,38850448,77780097,2697579,116988,50950,68860,2435576,2651180,5323554,5086756,0,5096175856,78704175,18379,[GP70]Glorious Phoenix
164037997,MÄD Asphar35,38841059,39004066,2402834,328132,315873,545201,2819373,396608,4405187,3215981,0,3632919242,95504717,11786,[GP70]Glorious Phoenix
158949811,SvคRoG,38630591,74793965,3182380,1905755,3224181,2341473,5162638,348609,12982656,5511247,0,5373982100,114999737,29765,-
108100494,爪onkeyD Luffy,38566232,222600225,8197725,10559317,5537101,3250070,9259456,5190966,33796910,14450422,431688,7153182316,1300000100,43964,-
160109731,BeefyT,38340753,11191548,612552,114180,152726,182370,544594,234392,1228262,778986,0,5297060603,46500358,15223,[GY70]Glorious Yokai
160269508,ˢᵖDiscoStu,38211318,43856980,1297853,188642,363792,151237,1720252,1264210,3688133,2984462,0,6358914647,784771567,22080,[GK70]Glorious Knights xXx
163308486,JakeSullyFarm,37756510,70512780,2680808,2242202,1178974,149928,4808100,951284,9330488,5759384,0,3633012205,329241378,18972,[GK70]Glorious Knights xXx
159980213,Notᴮᵒˣʸ,37684590,14385604,2678462,23121,110482,27624,929088,237932,1328247,1167020,0,7888402082,4069223170,6869,[GY70]Glorious Yokai
163427468,Kainn,37562252,656252150,6302190,33841954,7541371,6139102,42864711,9059875,99447013,51924586,0,4654710750,986829743,106906,[GP70]Glorious Phoenix
166400911,AdRock,37527854,29733963,2242769,408235,31476,17466,1392180,779885,2629242,2172065,0,7641236923,994420834,14407,[GK70]Glorious Knights xXx
163273598,ᴹᴰMeoMeo鬼,37506315,168791406,3014116,16705671,786809,1877761,12423571,1606495,33400307,14030066,0,8327571880,1343595826,15759,[GP70]Glorious Phoenix
153778587,KENESARY KHAN,37352119,45490393,3826362,2794798,402570,705991,2848077,641078,7392514,3489155,0,6253152459,233727053,13798,[GP70]Glorious Phoenix
165208712,BOB BERG,37312235,167753243,3202852,5931435,1217206,1046471,13939714,1027476,23162302,14967190,0,6130293570,1438628423,19504,[GP70]Glorious Phoenix
160005517,Kenny youshe,37195152,17842016,3036363,49444,133211,30594,837715,453309,1504273,1291024,0,5041125961,167231,13193,[GK70]Glorious Knights xXx
163204635,ᴳᴷFlo147,37162103,42565416,2442651,131650,259558,87470,1644007,1261501,3384186,2905508,0,6610093417,557104923,17526,[GK70]Glorious Knights xXx
162500011,Notᴮᵒˣʸ1,37050956,11559074,844094,5054,11944,564,504158,324517,846237,828675,0,7506963085,3803337760,7393,[GY70]Glorious Yokai
165211813,水melons,37043628,27424340,1486752,135714,34594,78190,1074759,813383,2136640,1888142,0,7333731512,2726486462,6247,[GP70]Glorious Phoenix
163896786,LORD ATHOOS,37000679,129275480,2393402,2405934,211527,186265,5802914,3479852,12086492,9282766,0,5853228355,89546000,19023,[GP70]Glorious Phoenix
163281739,geege,36941978,95620891,3493376,349828,88704,78447,5920305,1792834,8230118,7713139,0,8114202831,299000000,24667,[GP70]Glorious Phoenix
163802572,Ｃａｆé,36928345,347758099,5677819,12990667,2380545,3357374,23160982,4767978,46657546,27928960,0,7772353395,1103977879,51172,[GP70]Glorious Phoenix
163999253,ᴳᴾSobisz,36883606,145395644,2592835,24303521,1452644,1380018,10944130,1133414,39213727,12077544,0,4920973542,268700989,34263,-
164051524,UncleJye ᴳᴾ,36576681,221168774,2317897,947150,1244102,3581200,19633076,391779,25797307,20024855,0,2151341518,6040148115,13093,[GP70]Glorious Phoenix
130939889,FDE,36498097,59477580,2790954,987732,90026,252233,3588277,1110414,6028682,4698691,0,6746680381,75000000,25987,[GP70]Glorious Phoenix
159598342,VeNoM94,36318732,26984305,3993969,190287,326968,232283,766442,884938,2400918,1651380,0,4286730303,21600000,5526,[GP70]Glorious Phoenix
163311943,ᴳᴷLuciusV,36287386,23250612,3700266,228051,125865,247968,1339144,428498,2369526,1767642,0,7077489285,102582000,18674,[GP70]Glorious Phoenix
163398298,LordElcore,36013500,33092484,3248788,388620,837938,467841,1613710,666521,3974630,2280231,0,1267178626,2373851376,5805,-
164136033,ImKatiexoxo,35907470,22938016,3021426,243380,461239,27933,665679,759917,2158148,1425596,0,4206949014,277675938,4078,[GK70]Glorious Knights xXx
48975862,Just M I T,35787338,182866534,7441016,8651181,747311,1014474,8888358,4335010,23636334,13223368,0,7758438749,2391105658,15205,-
165035908,Mothernois67,35149532,814495,9796,36718,47588,37964,32614,11699,166583,44313,0,6254553875,274122770,8536,[GK70]Glorious Knights xXx
164053770,ᴳᴷAlpinine,35018820,59356929,3505463,5563629,551652,545620,2891684,1302079,10854664,4193763,0,1993305320,1002581456,17554,[GP70]Glorious Phoenix
164129282,Sheetbarbecue52,34877268,690351,14753,306,7442,10464,61533,911,80656,62444,0,3860504871,0,3923,-
2900444,MarieAntoniette,34878826,7086171,1744985,42348,26713,20234,458590,117872,665757,576462,0,4291577629,1750492864,6562,[GP70]Glorious Phoenix
164121961,ᴳᴷFallenGod,34851242,114706486,4055234,241971,149005,56783,4355719,3528788,8332266,7884507,0,5325106983,75853883,34889,[GK70]Glorious Knights xXx
163265067,Pinky RabbitPoo,34832447,58327713,3440512,2597449,639572,237380,4010584,773686,8258671,4784270,0,5084046692,475211326,14266,[GK70]Glorious Knights xXx
159988756,Epcot Lake,34602825,38292772,1950097,102334,127611,178466,1496250,1117036,3021697,2613286,0,6162835144,634237205,9789,[GK70]Glorious Knights xXx
171004946,CbtSptSl0th,34547836,20398083,1186891,326039,14687,4068,1330975,348874,2024643,1679849,0,7082029233,1313200000,9256,[GK70]Glorious Knights xXx
166099583,DZ Boss,34446523,16281538,95096,197372,195685,114381,1537365,976,2045779,1538341,0,6111964508,0,4475,[70Gk]G Knights Academy
164837011,NeoHan,34343989,29603361,2748143,155417,547160,311817,1237351,742859,2994604,1980210,0,7650665746,188784951,21562,[GK70]Glorious Knights xXx
167476628,kocaaga,34199440,13911425,2573603,85339,1299011,79934,669266,214197,2347747,883463,0,5433463246,2900328707,18042,[GK70]Glorious Knights xXx
70903201,BlitzFarmGold2,34002646,28949450,6381118,202890,203440,429688,1394034,642145,2872197,2036179,0,12897573173,11004438651,4698,[emo]TR-90
163982975,PowerForDragon,34002247,105421940,497576,3853144,2198773,1487754,8786781,321747,16648199,9108528,0,3862147626,637165469,42623,[GK70]Glorious Knights xXx
164002440,peace of sadnes,33986640,81315110,4145898,343180,653349,930219,6594740,513575,9035063,7108315,0,5567263595,1045371266,319,[GK70]Glorious Knights xXx
65417466,castely roxk,33855109,15898347,1893017,60538,88847,28014,527111,516269,1220779,1043380,0,3291714550,280163444,7591,[GK70]Glorious Knights xXx
164601207,BlitzGold,33791872,45964893,1121716,692187,84304,255407,3108782,677420,4818100,3786202,0,3993099262,4117068944,15515,[emo]TR-90
162585954,TürkReisss,33674637,104389302,2147932,4772480,6503458,1221530,7208507,672835,20378810,7881342,0,5050197334,1384324646,23936,-
163309552,Safron11,33583161,77287613,1745268,1402006,618905,1391043,5311759,854382,9578095,6166141,0,3608315513,28624515,24524,[GK70]Glorious Knights xXx
152419157,Saad27,33563163,14018062,4185204,109462,277229,347823,380202,412420,1527136,792622,0,4113813640,842580,5418,[GK70]Glorious Knights xXx
163885911,MÄD Katherine,33275157,121643073,4966269,2522826,3129272,1277856,6577800,2199527,15707281,8777327,0,3940238247,293380073,13345,-
48085511,Chunkychaz,33192448,6754904,2426373,35482,63030,102867,161870,229579,592828,391449,0,5672635580,406037486,12333,[GK70]Glorious Knights xXx
132144703,MomyFenryr,32587436,35147978,558100,159790,109041,105557,2640521,403525,3418434,3044046,0,1881150108,383985580,20933,[GK70]Glorious Knights xXx
164077358,Gunsmoke3595,32468677,13733973,2108391,655449,1052366,475823,718444,120521,3022603,838965,0,3520419583,0,8896,[GK70]Glorious Knights xXx
164004785,SP00DERMAN,32323881,22606974,2698883,1238973,890702,41394,1228570,406325,3805964,1634895,0,2319626066,436351169,7788,[GK70]Glorious Knights xXx
158431304,ØᵂBurNz,32284923,58629154,3001678,208724,210852,160724,3781563,985359,5347222,4766922,0,5832629606,149903393,8083,-
164068071,alicity,31943839,8976505,3345013,306597,113774,107662,406895,209402,1144330,616297,0,6024456482,1692594,7831,-
160076222,ˢᵖWILD KAOS,31909563,9605892,2048674,27094,208513,163217,332318,260370,991512,592688,0,4566931745,40519744,8527,[GK70]Glorious Knights xXx
164141548,Aureleke,31808867,291955,0,1679,416,5842,2050,12346,22333,14396,0,4113626954,80171705,12549,[GK70]Glorious Knights xXx
160188937,ᴳᴾ Rin1397,31745922,108488159,4792397,2661109,1461838,1102113,7386451,1337965,13949476,8724416,0,6419911836,2848937353,30880,[C~TO0]EIOlympus
164018223,彡NøBødy彡,31728431,8452005,890448,12449,18445,220589,401051,175988,828522,577039,0,2822697499,28184337,4351,[GK70]Glorious Knights xXx
169045142,Flint3100,31618746,7696390,2845636,15601,45081,6302,221468,268161,556613,489629,0,2332709452,0,10412,-
159982370,Alepeo,31046202,26046615,2743446,513769,22099,50931,1655340,457127,2699266,2112467,0,4442641981,157810343,14956,[GK70]Glorious Knights xXx
107985386,URHf1000,30838884,75215539,6218923,4497405,403179,158570,4252964,1517289,10829407,5770253,0,23051110338,24798854629,40577,[GK70]Glorious Knights xXx
163526319,lordAslan,30778084,6782059,3795703,3709,7585,29932,271088,196777,509091,467865,0,2128071372,232463525,8751,[GK70]Glorious Knights xXx
163342520,衁GARISKERAS,30751350,40969874,2763589,929112,1139119,1045526,1973301,729535,5816593,2702836,0,6353080612,168000000,18285,[GK70]Glorious Knights xXx
116402598,ᵛᶦ Lenwëë,30711234,64486101,5463978,651796,347300,291273,5235323,507141,7032833,5742464,2182,7923539932,1776962580,6246,[GK70]Glorious Knights xXx
164035194,Aïdan,30579880,2173588,557724,77924,47479,4784,60763,71814,262764,132577,0,1098678758,124171827,5117,[GK70]Glorious Knights xXx
167915192,TR ROCK FIRE,30514838,34058407,1528202,781829,71368,51334,2399049,478174,3781754,2877223,0,6054559583,448738924,4685,[GK70]Glorious Knights xXx
164276560,Alloni95,30456593,17975942,2842145,383464,192410,103545,1013235,348395,2041049,1361630,0,4298714873,102750010,9337,[GK70]Glorious Knights xXx
160604924,LongNónLázzz,30323992,215060665,4703957,64008199,4386415,4517949,15565514,987963,89466040,16553477,0,6023854451,47793883,7440,-
177894980,Janus farm1,30094070,297676,18732,15381,0,0,29460,0,44841,29460,0,7529405260,1940000000,3907,[GK70]Glorious Knights xXx
168820925,ᴳᴷShinbyysa,30044849,51345597,1492890,172505,1311466,438161,2415660,1138946,5476738,3554606,0,6587342410,576567789,5497,[GK70]Glorious Knights xXx
160107451,ᴷs EliseOneヅ,29980409,25769067,489580,1123346,46634,56735,2370601,75909,3673225,2446510,0,5026788511,2322931145,7267,[GK70]Glorious Knights xXx
160028486,FoolFighter,29948632,9579040,2765727,25351,9112,53814,462521,235764,786562,698285,0,3774707470,71401110,7836,[GK70]Glorious Knights xXx
27342929,EZ Gazda Mini,29936116,16858594,3221861,25151,3219,2104,536437,573717,1140628,1110154,0,12604142256,16582221116,6366,[VH70]Valkyrie Hall
164116091,ᴳᴷReiLopes,29874608,29358694,1159497,287651,475920,571711,1667228,469510,3472020,2136738,0,3545661449,802126409,10606,-
153876400,々 YORU 1,29695031,30517509,2507431,1401497,552259,528858,1894568,403579,4780761,2298147,0,5285898669,3788187008,11532,[GK70]Glorious Knights xXx
163282606,ᴳᴷ Mustang,29233711,14971176,1542182,85491,46331,9494,247488,617428,1006232,864916,0,3917660771,11213905,18087,[GK70]Glorious Knights xXx
163241446,Spartans 301,29181859,791221,90123,20426,19173,121570,26251,0,187420,26251,0,2538234769,13469767,4142,[GY70]Glorious Yokai
159270030,Ara kawaii,29167296,136992385,2888620,21150205,3481587,2261745,10053137,811041,37757715,10864178,0,3263386870,2725923831,60399,-
167894916,ᵀᴿ Makuada,29104767,27635414,598975,172331,69532,19196,1446986,645762,2353807,2092748,0,2939874971,377963239,27671,[GK70]Glorious Knights xXx
162013785,DrzOmarr,28817374,5321854,1559170,32632,21522,374061,223966,76819,729000,300785,0,4656496541,61966622,6972,[GY70]Glorious Yokai
164019944,AgentKokos,28809275,12189204,2760724,647422,1428445,998150,273741,123641,3471399,397382,0,3537500363,4438756,3444,[GK70]Glorious Knights xXx
162170956,Roobear1227,28486519,20623952,2730250,506223,282508,255638,1131900,380807,2557076,1512707,0,4073305695,955723360,7324,[GK70]Glorious Knights xXx
162803477,AtraxRobin11,28350923,12688815,3072205,738535,1154369,1505380,213417,103834,3715535,317251,0,4777776802,494374247,4668,[GK70]Glorious Knights xXx
164057853,ぽんげ,28333093,15881056,3841073,285492,840190,672827,523085,311071,2632665,834156,0,9892672907,0,728,[GK70]Glorious Knights xXx
163358920,Home Body,28240730,46130238,3235806,536832,595885,1555338,3384913,238031,6310999,3622944,0,5297413751,7862745122,45307,-
164128465,Billmoney,28206134,15065507,3100351,260607,186369,63197,1028882,204952,1744007,1233834,0,4227392334,86586153,11094,[Aiz]Mercenaries guild
168197815,MajorRufus,28180913,5235679,1091904,189176,317382,214425,226248,72145,1019376,298393,0,3231664341,19729041,4525,[GY70]Glorious Yokai
163225067,DoggyStuff,28037418,24467704,2332429,358360,398752,972867,1153290,408708,3291977,1561998,0,3478126418,0,4089,[GY70]Glorious Yokai
163262788,Skunkic,27929538,23346322,2896774,112773,26461,31764,1299011,507684,1977693,1806695,0,2846144638,43320646,10246,-
163969106,PeternakanSatu,27818108,68899725,2564405,4399796,1107568,2024080,5162157,304337,12997938,5466494,0,4472361546,1897810310,10767,[P70A]-Phoenix Academy-
164023730,Jobim,27760171,7005856,2670889,79350,48238,24475,233065,223248,608376,456313,0,4134789262,668000,4916,[REVF]Revolutionary Fist
164027874,LoryAlbert,27723261,8616114,1809529,633544,993203,220060,509336,26470,2382613,535806,0,3316414025,75331040,3360,[GY70]Glorious Yokai
168909546,Sienna123,27722485,14047916,508874,1694871,213343,126169,786678,245540,3066601,1032218,0,2141881302,150221355,20534,[GY70]Glorious Yokai
136277672,TC ÖZKANfarm1,27641694,26930056,3934409,1625860,15612,5850,1000800,827113,3475235,1827913,0,15366199612,12106494831,4814,[GP70]Glorious Phoenix
164116819,ᴳᴷFish,27506853,7286764,2851286,141651,426124,170939,350301,110971,1199986,461272,0,4379434472,8000000,2047,[GK70]Glorious Knights xXx
163526168,Mad Priest,27297499,21206399,2598718,551505,1509019,933475,852796,290810,4137605,1143606,0,5788904284,2118121824,11752,-
164115303,Rudy le roi,27021570,18149504,3288137,964930,1992837,1392551,745206,47429,5142953,792635,0,3920949071,4000000,7207,[70GA]Glorious Academy
164066145,ᴳᴷSylviioo,26930954,12779770,4002365,242782,490129,63834,616138,266712,1679595,882850,0,5007344417,403675036,17640,-
163340476,ᴳᴷRoleme7,26815217,45946114,3223704,667873,181419,913448,2923345,628123,5314208,3551468,0,2826846379,12595000,10641,-
164043834,mrsnackermanll,26644715,2874291,462713,78617,170083,5858,230713,9392,494663,240105,0,3149729673,32502870,4098,[70Gk]G Knights Academy
97480293,PETIRR FARM,26509402,24793078,1069547,812262,1306267,941868,1474462,175300,4710159,1649762,0,5400400030,1479424133,20519,[GK70]Glorious Knights xXx
159508617,MikeTX Farm,26249952,2366173,434383,12066,19439,9138,160985,33924,235552,194909,0,10075416849,7399333044,5792,[GK70]Glorious Knights xXx
167183418,ᴹᴿメPhoenix,26225226,11562553,1670451,1455609,1639742,607782,391394,82344,4176871,473738,0,5065770586,134498286,3624,[GK70]Glorious Knights xXx
161321238,ᴳᴷVikingos,26102703,16665583,4621024,523119,506395,358775,748123,331592,2468004,1079715,0,6026769805,1174658492,9257,-
163342859,Capitán pS,25951027,196945470,2934012,1550010,2034771,1935694,15531381,1475467,22527323,17006848,0,2732394272,135634934,10753,-
164108821,adri106,25917901,5694967,261205,341788,513651,194492,382134,0,1432065,382134,0,3631776870,16215806,4277,[GK70]Glorious Knights xXx
102578194,ᴮˢGuan Yu 21,25877614,27976368,5279855,802642,1454327,1305669,1256339,356056,5175033,1612395,0,11829696146,6525581708,9403,[P70A]-Phoenix Academy-
146412422,MBAH RUSIK,25776563,23590904,2213430,111870,297612,249504,1065057,566236,2290279,1631293,0,3785793440,634366850,9313,[70Gk]G Knights Academy
164097918,Antonius Gaius,25754589,7447001,2439762,103367,144353,776703,255971,73555,1353949,329526,0,2721635119,6515500,3893,[70Gk]G Knights Academy
162479586,AMiiR,25717188,83219282,2735818,6856481,2851713,5547620,4682052,356678,20294544,5038730,0,3403975392,408861738,12297,-
163834466,nassim13,25651103,13169641,2885474,506349,706189,1501646,271543,146699,3132426,418242,0,4259161864,299658783,11126,[waw!]lwelkome_and_worl
164125091,HLC2023,25663589,4335532,1643954,28841,78039,17389,157077,126668,408014,283745,0,4984398332,9600000,7244,[GY70]Glorious Yokai
164552580,JOHNATANZF,25611302,536130,60333,10862,23391,11264,44212,0,89729,44212,0,8841058653,3842307780,2095,[70Gk]G Knights Academy
164061734,FirePhoniex,25539895,18390816,2393287,173462,28405,15341,1212553,305621,1735382,1518174,0,3963938211,27363467,5704,[GK70]Glorious Knights xXx
170083059,Galadriel シ,25533233,16549384,527927,67482,55275,17832,1568589,33406,1742584,1601995,0,2925598700,639193605,2296,[GK70]Glorious Knights xXx
164071410,Putri Zhafira,25519255,5272888,1549236,50861,138263,21810,410977,39459,661370,450436,0,3768927454,38500000,4313,[GK70]Glorious Knights xXx
164030210,Lanuriel,25514948,3273869,1873242,14949,61773,28981,128799,87171,321673,215970,0,3927493047,3599996,1903,[GK70]Glorious Knights xXx
163757892,ᴳᴷAethersR5,25449396,2143121,287979,14285,17237,36260,175437,10319,253538,185756,0,1429933927,121257155,3938,[GK70]Glorious Knights xXx
164033978,Mansicle,25424653,11840291,3760488,916599,645340,291238,774678,72728,2700583,847406,0,8272534927,0,2766,-
163691366,Little CAT,25319244,7065519,2045043,146,33,1,291248,207647,499075,498895,0,5457237190,546008511,5326,[GY70]Glorious Yokai
78690195,Taxi F,25237953,37936732,1753047,1075023,1335821,1246064,2116259,445162,6218329,2561421,0,4602651468,1303063440,21658,[7OPf]Farmers of Phoenix
164098059,SmoKKeR,25172567,67601239,3985936,2879266,1372312,898638,3040263,1514179,9704658,4554442,0,4415657160,224585818,15782,[GK70]Glorious Knights xXx
136374571,Hizoka hxh,25143371,132804239,2050547,1636506,913268,1497238,10715465,875340,15637817,11590805,0,10836676715,19734708165,43718,[70Gp]GPhoenixfarm
173418169,RokTrial001,25018662,19397,0,7177,8981,0,0,0,16158,0,0,6670384001,0,2224,[70Gk]G Knights Academy
105162690,As Guan yu  21,24950742,20251959,5063114,24126,4466,798,1233391,395055,1657836,1628446,0,11757741932,4226849797,4370,[P70A]-Phoenix Academy-
158925766,Madalynn,24943812,25529991,2264730,146835,83258,298387,2356220,28918,2913618,2385138,0,4764599613,357106222,2688,[GY70]Glorious Yokai
163130517,Vanilla Pudding,24893756,2027651,42129,29697,149811,0,4827,83691,268026,88518,0,1532810650,0,2536,[GY70]Glorious Yokai
164491773,ᴳᴷJinx,24811591,16180482,2236987,474712,470190,564240,769846,259487,2538475,1029333,0,4538200270,385137603,8849,-
159980673,ˢᵖSaad,24805723,4425316,499310,100900,232435,69639,335867,15152,753993,351019,0,2521990838,1912480,4079,[GK70]Glorious Knights xXx
173483039,RokTrial002,24661216,1221530,273100,31994,134966,116685,47846,0,331491,47846,0,6513199953,0,2636,[70Gk]G Knights Academy
164015540,khangAAA,24609238,131740,23296,3612,36235,6917,3088,0,49852,3088,0,3611127113,0,4134,[GY70]Glorious Yokai
116641661,GassiIIfarm,24589969,20207827,1761003,828148,2401055,1203117,811640,115561,5359521,927201,0,4929863994,1269993696,9748,[GK70]Glorious Knights xXx
162137731,abubote,24561785,219810,837359,0,0,0,21981,0,21981,21981,0,4047726615,229034143,1868,[70Gk]G Knights Academy
163167522,qcobra,24387856,12784708,2577516,239810,539111,254741,496876,283540,1814078,780416,0,3493948711,68861,9006,[GY70]Glorious Yokai
141743531,Dâu 鬼,24183138,98539618,2586303,3788852,1608175,950942,7517415,779379,14644763,8296794,0,4494655590,1193370754,27807,[7O0Pf]Farmers of Phoenix
160872250,ᴳGenTynヅ,24100437,64226515,1310106,3137238,5420027,4058766,3448313,102041,16166385,3550354,0,3674892302,910099154,14770,[GK70]Glorious Knights xXx
67389770,BlitzFarmWood2,24058622,4629393,1449937,186165,232818,40456,216868,89801,766108,306669,0,9194471996,7508653912,3525,[emo]TR-90
164384573,DemonDrago,24018143,3270914,306872,116414,44743,3964,303563,5333,474017,308896,0,3658285511,115626966,4627,[GY70]Glorious Yokai
164078857,Guti007,23857749,2514122,2338970,76350,99602,162637,27424,68743,434756,96167,0,4643263972,4800000,1211,[88GZ]NOVACBABENGZ
125765323,Sarhad,23725273,6754879,3335573,291665,353263,322535,257628,106180,1331271,363808,0,4069685796,278146171,2111,[REVF]Revolutionary Fist
163908542,Fergie,23676205,2475003,2123055,9177,5403,5883,4589,119647,144699,124236,0,3936758469,0,2197,[GK70]Glorious Knights xXx
65553431,Ɓƴ   ƁeLâ,23584121,4503626,2137425,22070,3453,19,222149,113537,361228,335686,0,4271139689,1130010996,2824,-
1381305,TC EMRE 3,23461973,15229796,2758022,50812,52652,128945,129601,665127,1027137,794728,0,4157221361,3111802738,14804,[emo]TR-90
164056291,Linhxing,23412027,2807521,1378939,171037,597640,119756,10705,49598,948736,60303,0,3280545324,1549958,3197,[GK70]Glorious Knights xXx
164120227,Mavrikiller,23368274,5090874,1865400,20174,37487,9229,134231,181632,382753,315863,0,4355383742,0,5428,-
163332710,ᴳᴷPapaMini4,23285762,16067690,2204763,365601,519000,181630,1238025,92490,2396746,1330515,0,3690324741,353160177,17827,[GTON]GoldenSight
161891593,ˢᵖWKA1907,23230804,2116139,1280277,5928,4064,37254,44319,75731,167296,120050,0,3617613616,169342463,3693,[GK70]Glorious Knights xXx
164924487,GP FARM,23209795,90035303,2625769,13795227,5580865,5542067,5255990,69318,30243467,5325308,0,4416022039,170800000,4177,[GK70]Glorious Knights xXx
164027961,arronn,23155221,22677906,2875208,320062,395904,211169,1277037,410352,2614524,1687389,0,3513102592,37200000,9410,[GY70]Glorious Yokai
163342787,ᵐˢMoon,23154562,41136955,189724,3592745,1034350,1345929,3235205,30697,9238926,3265902,0,2364200914,0,15411,[GK70]Glorious Knights xXx
164091673,G0rg0n,22922458,1935882,364133,75063,103545,25555,158734,1211,364108,159945,0,3142093686,0,3375,[GY70]Glorious Yokai
43395863,imyourmajesty,22866707,6892748,5320266,38972,206989,65154,293202,163917,768234,457119,0,7099472889,25470998,3757,[GY70]Glorious Yokai
120157934,乄EşkiyaTaner,22673986,15659871,1587709,1022649,2116327,1202872,588008,26556,4956412,614564,0,1969316488,936515998,3122,[GK70]Glorious Knights xXx
166083767,ᴳᴷforwhom,22742727,15828332,1848875,124532,134385,123749,1323744,90111,1796521,1413855,0,3172591299,198600271,44,[GK70]Glorious Knights xXx
26390587,SongV,22562696,27550237,4352601,2871165,892814,535979,1149576,577535,6027069,1727111,0,9367166942,7670756331,4500,[GY70]Glorious Yokai
164739142,Dab2,22538300,2746103,1370737,6655,7406,11495,127110,70644,223310,197754,0,3650203484,1130718945,1920,[GK70]Glorious Knights xXx
164027959,Simmoura,22517881,39047976,1398911,79951,189222,324028,1627643,1054050,3274894,2681693,0,4471458241,271928289,8004,[GK70]Glorious Knights xXx
64794925,BlitzFarmWood,22214970,7616774,2153203,216780,232996,407964,354129,96714,1308583,450843,0,8923065390,4642353571,2634,[emo]TR-90
164658483,Tesa Putri,22186226,5072891,1497853,356756,216256,26012,446498,0,1045522,446498,0,3488810019,39500000,3399,[GK70]Glorious Knights xXx
150841831,ʀᴀSÂKUNÂ,22105510,48054506,2272827,1124402,2339805,1917459,3184346,181836,8747848,3366182,0,2112193474,1048733729,28602,[GY70]Glorious Yokai
164057997,MrPelón,21977343,23551,54,7246,1971,0,1816,0,11033,1816,0,4103722713,3500000,1119,[TOKF]KNIGHTS_FARM
163336232,Who he,21932020,113550099,2098968,1989345,2884662,1640349,9072025,505063,16091444,9577088,0,2239724370,2141007556,43938,-
134263856,TC EMRE 2,21906569,6209534,1822279,21110,25057,3322,222951,195620,468060,418571,0,5756948038,4090399495,3003,[emo]TR-90
150895499,ᴷᵂ Thần,21899258,46105517,2787541,249449,334225,166032,2433777,1019264,4202747,3453041,0,3807851422,174621017,23150,-
164020937,Morkvarg,21876360,3330371,1464530,217445,146969,99461,216246,21632,701753,237878,0,3011469780,0,387,[70Gk]G Knights Academy
91109857,ᵐᶠDoomToon,21645552,2349896,1561452,97852,298221,24591,113740,24906,559310,138646,0,4905846127,2553506176,5617,[GK70]Glorious Knights xXx
163500609,nimrods son zzs,21645375,2614234,298539,215791,459223,70020,132821,2217,880072,135038,0,1980819584,15019222,4416,[Zzs2]zzs 222
160753271,Quân Kĩ Năng,21643972,14809722,1879741,281303,250744,26846,1122051,146204,1827148,1268255,0,3807312274,98014605,5489,[GK70]Glorious Knights xXx
164076209,Dark imperoR,21577174,6206059,2475642,78149,132584,73918,238187,162386,685224,400573,0,3194428144,2000000,3951,-
171543337,BaumwartFarm,21315660,916055,764895,1879,19393,82431,53473,622,157798,54095,0,6326204253,3045203675,2852,[GK70]Glorious Knights xXx
162150036,ᶠᵁDADDYKHAN,21286664,33522114,1236981,1624510,2247835,699968,1902007,344080,6818400,2246087,0,1253884476,382109586,17678,-
140979503,ᴳᴷ John303,21002395,1199736,119549,22053,34460,24164,85703,8636,175016,94339,0,1518808529,52200000,2124,[70Gk]G Knights Academy
164008118,メ B A R R A メ,20998680,4403811,1118448,63395,253457,12807,272165,55567,657391,327732,0,2832995256,0,4405,[70Gk]G Knights Academy
168624278,Salice,20962632,3167625,419437,1523288,22627,18751,187215,43528,1795409,230743,0,2721568466,93356880,6398,[GY70]Glorious Yokai
98810302,BlitzFarmStone,20920015,9236765,879961,617037,320860,84057,507381,153080,1682415,660461,0,7389341848,4826018502,2609,[emo]TR-90
164120218,Viingador,20875420,5204943,1841680,205197,656686,270063,144220,66404,1342570,210624,0,2647458553,48559012,4571,-
162886375,SéxyAlphaWolf,20866546,47102420,1725872,687812,406272,327661,4375603,54282,5851630,4429885,0,1302598717,163278473,26247,-
141742582,Lê 鬼,20848829,28423093,1892888,947945,1032137,364045,2340387,65459,4749973,2405846,0,4865518451,1434554107,15163,[7O0Pf]Farmers of Phoenix
163412266,ⱽEvil C4RN4G3,20779781,3847784,1598873,522210,1059575,32658,69122,40117,1723682,109239,0,3284416610,3602230,6043,[70Gk]G Knights Academy
163998462,papatyiş,20778777,1143710,736783,54324,60684,162152,25223,5532,307915,30755,0,2155005817,0,2968,[70Gk]G Knights Academy
169936006,LittleRoo,20711466,1041893,293424,41148,0,52971,82178,0,176297,82178,0,2516427763,236831813,1578,[GY70]Glorious Yokai
150873226,HuntedbutnotKL,20657699,17482683,1902503,650685,793797,511368,1160564,105692,3222106,1266256,0,6682225772,2447812514,8236,[70YB]Yokai Bootcamp
123263811,Táo 鬼,20425305,26172985,775985,397475,517249,578118,2237548,18552,3748942,2256100,0,3977714038,970419121,31172,[7O0Pf]Farmers of Phoenix
163856855,KoYYoShĪ,20405807,16802197,1633933,1829809,242003,67025,1146905,210754,3496496,1357659,0,4007918499,93477936,20697,-
174255833,Owuevuevue,20325204,3734570,84465,0,0,0,373457,0,373457,373457,0,3467583351,10126000,1937,[70Gk]G Knights Academy
171907022,punisherfarm07,20284555,3478640,842436,0,0,0,347864,0,347864,347864,0,6047674790,940733571,1256,[VH70]Valkyrie Hall
112038772,柱MightyOreo,20193275,14357177,782636,378468,831259,846869,818193,52478,2927267,870671,0,2216408777,1174937830,10035,[GK70]Glorious Knights xXx
172330996,PunisherFarm07,20051683,3376570,623266,0,0,0,337657,0,337657,337657,0,5749061473,1013087038,1298,[VH70]Valkyrie Hall
50477016,JYE F1 I F,19930420,8757671,1877059,296796,493026,130860,680786,19048,1620516,699834,0,2771757158,1301948450,3995,[70GA]Glorious Academy
159232553,FujiMini,19920271,6190546,269924,288360,86507,20640,587730,0,983237,587730,0,5939641516,5223103520,2376,[7O0Pf]Farmers of Phoenix
163162734,Thor75mini,19906728,4605991,417244,163759,481455,109710,289691,13729,1058344,303420,0,3307198393,10867000,4160,[GY70]Glorious Yokai
65568223,EnduringZero2,19662572,3605519,672951,3168,0,57744,48751,144320,253983,193071,0,11357495318,15143845821,3726,[VH70]Valkyrie Hall
162166150,RellisATTАСҚ,19662439,22912673,2457753,421958,1298779,151366,1246654,357936,3476693,1604590,0,1982328087,406878557,2453,[70Gk]G Knights Academy
164521821,gondal,19536044,15071236,840696,796320,307886,54915,902308,252673,2314102,1154981,0,4142029357,5393399243,10346,-
163978959,tthaor,19519720,1287898,309932,43924,141283,115407,53492,0,354106,53492,0,2777704785,104090180,2926,[70Gk]G Knights Academy
163800609,ᴳᴷJERRY,19323712,39200050,2789845,1657752,1026483,1149851,2597847,311883,6743816,2909730,0,4820677747,2234968537,12257,-
164132727,ᴺᶜSirOwen,19236737,2257474,1891618,27754,106536,47628,32728,76053,290699,108781,0,3954698936,3813656,3550,[GK70]Glorious Knights xXx
156175577,TC ÖZKANfarm3,19235182,1615546,1354803,0,33,0,19610,70969,90612,90579,0,7925130619,5103321975,1217,[emo]TR-90
156169024,TC ÖZKANfarm2,19234377,2013493,1431920,6,0,19203,83600,55034,157843,138634,0,7918122647,5125659480,1342,-
162275059,Nickandadi,19214987,26625662,514671,431293,145097,246530,2526309,0,3349229,2526309,0,2331595275,177147222,2792,[GK70]Glorious Knights xXx
163531735,420Ninja77,19146385,3153959,781028,13458,5914,5835,165944,72833,263984,238777,0,2472825525,93642233,2363,[GY70]Glorious Yokai
170620926,Little Fool,19137902,453626,336480,131,0,0,45360,0,45491,45360,0,2035033589,90148951,1953,[GY70]Glorious Yokai
163378180,ᴼᴮArcusPyrr,19037945,3889565,1,7907,6802,119870,316994,11248,462821,328242,0,4865132382,0,11614,[GY70]Glorious Yokai
156037101,Yasin 28,18679989,10318869,2350272,253078,442569,422614,393490,187888,1699639,581378,0,3105856211,74101579,6812,[7T0gK]Aether Academy |
165036615,MAC11s,18675418,1973857,1294395,37888,47988,9366,105824,38730,239796,144554,0,2578933590,0,1914,[GY70]Glorious Yokai
27688741,EnduringZero3,18658450,35982,395838,1,1,0,0,1799,1801,1799,0,9451679222,10585886859,1671,[VH70]Valkyrie Hall
58385847,EnduringZero4,18635293,1951124,943226,1103,12656,2158,74,95811,111802,95885,0,9105959886,12384192048,3625,[VH70]Valkyrie Hall
89186224,Endu Baby,18597313,520806,641365,803,963,0,49002,1435,52203,50437,0,8995127492,10236015508,2067,[VH70]Valkyrie Hall
168339926,亗TAHİR亗F1,18537155,802200,94941,1031,11037,0,77992,0,90060,77992,0,4646695829,2231687999,1273,[emo]TR-90
139897662,ᵂᶠ Trang,18467594,10896572,2071851,111294,280366,310198,669345,118967,1490170,788312,0,3003842023,352526166,14458,-
151016387,PHK Queen zy,18441066,11734719,1252599,197889,255754,355361,866159,55030,1730193,921189,0,5960996746,4803367835,3057,[70YB]Yokai Bootcamp
162976452,DiscoStuFarms,18402543,199346,132234,11,49,49,19905,0,20014,19905,0,3087279715,750633491,1861,[GY70]Glorious Yokai
164060001,马修班地德,18363574,995875,561276,195238,143591,30659,16887,18907,405282,35794,0,3149981435,2171838,2218,[7OPf]Farmers of Phoenix
164307032,WilliamFin F1,18321317,586657,128181,42397,57296,7894,43201,0,150788,43201,0,4792361213,2400000,1458,[70Gk]G Knights Academy
173016996,JohnatanZF2,18318303,71080,0,0,0,0,7108,0,7108,7108,0,5365344261,1156530279,1176,[GY70]Glorious Yokai
163558152,ᵐˢBadman,18260477,14146336,923813,21303,24638,150760,1235314,56831,1488846,1292145,0,1256750839,0,4673,-
164018094,ELPablo501,18213762,670188,156235,121522,63937,3875,43575,3338,236247,46913,0,2596828621,2432691,1314,[70Gk]G Knights Academy
78137835,Basadaifarm2,18180202,31590461,2564463,1824525,2088760,2410704,1459154,140684,7923827,1599838,0,2515538888,3377379,10611,[GODmM]The_boyzz
159486604,ˢᵖ JibJab123,18143312,550292,456341,930,31495,24384,38958,0,95767,38958,0,2518402985,25812856,2722,[GY70]Glorious Yokai